*****G*********
*   *   *** * *
*   ***   * * *
*       * * * *
*******       *
*       *******
* ******      *
*      ** *** *
******  *** * *
*   *** *   * *
* *     * *** *
* ** ****   * *
* *     ** ** *
*   ***       *
*******S*******